attanssiyou : Attention
atansiou : attention
aurjou3 : hors-jeu
babor : bateau
balcone : balcon
baliza : valise
ballone : ballon
balone : ballon
balto : manteau
banda : bande
banka : banque
barabole : Parabole
barassioun : operation
barbrise : Pare-brise
bariziana : Pain-Parisien
barmeta : barmaid
barra : barriere
barteyya : partie
bart9iz : Portugais
barwita : brouette
baspour : passeport
kolou : mangez
koul : mange
n3es : dort
n3so : dormez
fi9 : reveille
fi9ou : reveillez
chrb : boit
chrbo : buvez
d7k : rigole
d7ko : rigolez
hrb : fuit
hrbo : fuyez
l3b : joue
l3bo : jouez
drb : frappe
drbo : frappez
ktb : ecrit
ktbo : ecrivez
sm3 : ecoute
sm3o : ecoutez
ch3l : allume
ch3lo : allumez
tfi : eteint
tfiw : eteignez
7sb : calcule
7sbo : calculez
3awd : repete
3awdo : repetez
lbss : habille
lbssou : habillez
7bs : arrete
7bsou : arretez
glss : assit
glssou : asseyez
ana : je
howa : il
hia : elle
nta : tu
ntia : tu
7na : nous
houma : ils
ntouma : vous
knt : j`etais
knti : tu etais
kan : il etait
kaant : elle etait
knnaa : nous etions
kntou : vous etiez
kaanou : ils etaient
fr7an : heureux
fr7ana : heureuse
fr7anin : heureux
fr7anat : heureuses
mchoki : choque
mchokia : choquee
mchokin : choques
zwin : beau
zwina : belle
zwinin : beaux
zwinat : belles